4440000000000000000000000000000000000000
4440000000000000000000000000000000000000
4441111111100333333300222222222222200000
0000000000100333333300222222222222200000
0000000000100333333300222222222222200000
0000000000100000000000222222222222200000
0000000000111111100000222222222222200000
0000000000000000100000000000000000000000
0011111110000000100000000000000000000000
0010000010000000100000000000000000000000
0010333010000000111111111111111110000000
0010333010000000000000000000000010000000
0010333011110000000000000000000010000000
0010000000011111111111111111111110000000
0010000000000000000000000000000000000000
0011111111111111111111111100222222200000
0000000000000000000000000100222222200000
0000000000000000000000000100222222200000
0000000011111111111111111100222222200000
0000000010000000000000000000000000004444
0000000010044444444444444444444000004444
0000000010000000000000000000000000004444
0000000011111111111111111111111111111444
0000000000000000000000000000000000004444
0000000000000000000000000000000000000000
